wwwwwwwwwwwwwwwwwwwwwwwwwwwwwwwwwwwwwwwwwwwwwwwwwwwwwwwww
w...........................m...........................w
w.w...w.wwwww.w...w.wwwww..wwww.wwww...www..wwwww.wwwww.w
w.ww.ww...w...ww..w.w.....w.....w...w.w...w.w.......w...w
w.w.w.w...w...w.w.w.www...w.....wwww..wwwww.www.....w...w
w.w...w.m.w...w..ww.w.....w.....w...w.w...w.w.......w...w
w.w...w.wwwww.w...w.wwwww..wwww.w...w.w...w.w.......w...w
w.......................................................w
w.......................................................w
wi..........................k..........................ow
wwwwwwwwwwwwwwwwwwwwwwwwwwwwwwwwwwwwwwwwwwwwwwwwwwwwwwwww