wwwwwwwwwwwwwwwwwwwwwwwwwwwwwwwwwwwwwwwwwwwwwwwwwwwwwwwwwwww
wwwww...wwwwwwwwww.www..wwwwwwwwwwwwww..w..wwwwwwwwwwwwwwwww
ww........wwwwww..........wwwwwwwwww........wwwwwww..www...w
w...........ww............wwwwww.w..............ww.........w
w....................m......ww.............................w
w......w...........wsw.....................................w
w.....ww............sw.....................................w
w....www.m..........sw...............m........m..........www
wswwwwwwwww..wwwwwwwwwwwwww..wwwwwwwwww..wwwwwwwwwww...wwwww
ws............m............................................w
ws............w...............m......................m.....w
ws............w...............w.......m..............w.....w
ws.......m....w...............w.......w..............w.....w
ws.......w....w....m..........w.......w..............w.....w
ws.......w....w....w..........w.......w...m..........w.....w
ws.......w....w....w..........w.......w...w..........w.....w
ws.......w....w....w..........w.......w...w..........w.....w
wsi.....www..www..www........www.....www.www........www....w
wwwwwwwwwwwwwwwwwwwwwwwwwwwwwwwwwwwwwwwwwwwwwwwwwwwwwwwwwwww
