wwwwwwwwwwwwwwwwwwwwwwwwwwwwwwwwwwwwwwwwwwwwwwwwwwwwwwwwwwww
wwwww...wwwwwwwwww.www..wwwwwwwwwwwwww..w..wwwwwwwwwwwwwwwww
ww........wwwwww..........wwwwwwwwww........wwwwwww..www...w
w...........ww............wwwwww.w..............ww.........w
w..........................www.............................w
w......w...........wsw......w..............................w
w.....ww............sw.....................................w
w...wwww............sw...................................www
wswwwwwwwww..wwwwwwwwwwwwww..wwwwwwwwww..wwwwwwwwwww..wwwwww
ws.........................................................w
ws............w............................................w
ws............w...............w......................w.....w
ws............w...............w.......w..............w.....w
ws.......w....w...............w.......w..............w.....w
ws.......w....w....w..........w.......w..............w.....w
ws.......w....w....w..........w.......w...w..........w.....w
ws.......w....w....w..........w.......w...w..........w.....w
wsi.....www..www..www........www.....www.www........www....w
wwwwwwwwwwwwwwwwwwwwwwwwwwwwwwwwwwwwwwwwwwwwwwwwwwwwwwwwwwww
